1,1,1,1,1,1,1,1,1,1,1,1,1
1,1,1,1,1,1,1,1,1,1,1,1,1
1,1,1,1,1,1,1,1,1,1,1,1,1
0,0,4,1,1,1,1,1,1,1,5,6,6
0,0,0,6,6,4,2,2,5,6,0,0,0
3,0,0,0,0,0,0,0,0,0,0,0,17
3,3,3,0,0,0,0,0,0,0,0,17,3
1,1,3,3,3,0,0,3,3,15,13,1,1
1,1,1,1,3,3,3,3,1,1,1,1,1
1,1,1,1,1,1,1,1,1,1,1,1,1
