1,1,1,1,1,1,1,1,1,1,1,1,1
1,1,1,1,5,6,6,6,4,1,1,1,1
1,5,6,6,0,0,0,0,0,6,6,1,1
0,6,0,0,0,3,0,0,0,0,0,6,6
0,0,0,0,3,8,0,0,0,1,0,0,0
8,8,8,8,8,1,0,0,0,1,0,0,0
3,1,1,1,1,1,0,0,0,1,1,17,3
1,1,1,1,1,1,0,0,0,1,1,1,1
1,1,1,1,1,1,0,0,0,1,1,1,1
1,1,1,1,1,1,17,8,8,1,1,1,1
